1111111111111
10000CC0CCC11
1011111111111
1000000000001
1111111111101
1000000000001
1011111111111
100000C000001
1111111111101
1000000000001
1011111111111
1000000000001
1111111111101
1000000000001
1011111111111
10000000P0001
1111111111101
1000000000001
1011111111111
1000000000001
1111111111101
1000000000001
1011111111111
1000000000001
1111111111101
1C00010001001
1C110001000E1
1111111111111