11111111111111111111
1111111C0100C001C001
101111C0010100000101
10C1000101000PCCC001
10111011010000000101
1000001C000110000001
10100000010000010101
1000001C000110000001
10100000010000010101
1000001C000110000001
101000000100000101E1
11111111111111111111