1111111111111111111111111111111111111111111111111
1P0C000C000C000C000C000C000C000C000C000C000C000C1
1000000011000111100011101100010111110111101111001
1C000C01110001001C00010011000101010101001C1001001
1000001101000000100001001010010001000100101001001
100C0110010C0111100C010C101C010C010C01111011110C1
1000110001000100000001001001010001000110001001001
1C011000010001001C0001001C010100010001010C1001001
1011111111110111101011101000110011100100101001001
100C0000010C000C000C000C000C000C000C000C000C000C1
1000001100011111011111011110001001001000101111001
1C00010100010001010001010010001010001000101001001
1000100100000001000001000010001100001000101001001
100C0001000C11110011110C001C0011100C11111011110C1
1000000100000001000001000010001010001000101100001
1C00000100010001010001000010001001001000101010001
1000011111011111011111000010101000101000101001001
100C000C000C000C000C000C000C000C000C000C000C000E1
1111111111111111111111111111111111111111111111111