11111111111111111111111111111111111111111111111111
1PECCCCCCCCCCCCCCCCCCCCCCCCCCCCCCCCCCCCCCCCCCCCCC1
1CCC11CCCCCCC11CCC111CC11CCCC11CCCCCCCCCCCCCCCCCC1
1CCC111CCCCC111CC10001C11CCCC11CCCCCCCCCCCCCCCCCC1
1CCC1C11CCC11C1CC10001CCC1CC1CCCCCCCCCCCCCCCCCCCC1
1CCC1CC11C11CC1CC10001CCCC11CCCCCCCCCCCCCCCCCCCCC1
1CCC1CCC111CCC1CC11111CCCC11CCCCCCCCCCCCCCCCCCCCC1
1CCC1CCCCCCCCC1CC1CCC1CCC1CC1CCCCCCCCCCCCCCCCCCCC1
1CCC1CCCCCCCCC1CC1CCC1C11CCCC11CCCCCCCCCCCCCCCCCC1
1CC111CCCCCCC111C1CCC1C11CCCC11CCCCCCCCCCCCCCCCCC1
1CCCCCCCCCCCCCCCCCCCCCCCCCCCCCCCCCCCCCCCCCCCCCCCC1
1CCCCCCCCCCCCCCCCCCCCCCCCCCCCCCCCCCCCCCCCCCCCCCCC1
1CCCCCCCCCCCCCCCCCCCCCCCCCCCCCCCCCCCCCCCCCCCCCCCC1
1CCCCCCCCCCCCCCCCCCCCCCCCCCCCCCCCCCCCCCCCCCCCCCCC1
1CCC11CCCCCCC11CCC111CCC1111CCCCCCCCCCCCCCCCCCCCC1
1CCC111CCCCC111CC10001CC10001CCCCCCCCCCCCCCCCCCCC1
1CCC1C11CCC11C1CC10001CC10001CCCCCCCCCCCCCCCCCCCC1
1CCC1CC11C11CC1CC10001CC1111CCCCCCCCCCCCCCCCCCCCC1
1CCC1CCC111CCC1CC11111CC1CCCCCCCCCCCCCCCCCCCCCCCC1
1CCC1CCCCCCCCC1CC1CCC1CC1CCCCCCCCCCCCCCCCCCCCCCCC1
1CCC1CCCCCCCCC1CC1CCC1CC1CCCCCCCCCCCCCCCCCCCCCCCC1
1CC111CCCCCCC111C1CCC1C111CCCCCCCCCCCCCCCCCCCCCCC1
1CCCCCCCCCCCCCCCCCCCCCCCCCCCCCCCCCCCCCCCCCCCCCCCC1
1CCCCCCCCCCCCCCCCCCCCCCCCCCCCCCCCCCCCCCCCCCCCCCCC1
1CCCCCCCCCCCCCCCCCCCCCCCCCCCCCCCCCCCCCCCCCCCCCCCC1
1CCCCCCCCCCCCCCCCCCCCCCCCCCCCCCCCCCCCCCCCCCCCCCCC1
1CCCCCCCCCCCCCCCCCCCCCCCCCCCCCCCCCCCCCCCCCCCCCCCC1
1CCCCCCCCCCCCCCCCCCCCCCCCCCCCCCCCCCCCCCCCCCCCCCCC1
1CCCCCCCCCCCCCCCCCCCCCCCCCCCCCCCCCCCCCCCCCCCCCCCC1
11111111111111111111111111111111111111111111111111